NO ./sprites/starship/wall_in.xpm
SO ./sprites/starship/ground2.xpm
WE ./sprites/starship/wall_down.xpm
EA ./sprites/starship/ground3.xpm

F 250,255,0
C 0,0,255


11111111
10100001
10100001
10100S01
10000001
10000101
11111111
