NO ./texture/wall1.xpm
SO ./texture/ground.xpm
WE ./texture/wallbed.xpm
EA ./texture/wall.xpm

F 255,255,0
C 0,0,255

11111111
10100001
1010N001
10000001
10000101
11101111
   1

