
F 255,255,0
EA ./texture/wall.xpm
NO ./texture/wall1.xpm
SO ./texture/ground.xpm
WE ./texture/wallbed.xpm
C 0,0,0

11111111
101S0001
10111001
10000001
10000001
11111111
